account_name,predict_class,prochoice_strength,prolife_strength,follower of,prolife proportion,prochoice proportion,prolife cnt,prochoice cnt,total cnt
ABabysRights,1,0.09614886533928924,0.9038511346607108,1,1.0,0.0,12,0,12
ABGYNservices,0,0.6819770001694787,0.31802299983052135,-1,0.0,1.0,0,9,9
Abigailschumach,1,0.28746250177971244,0.7125374982202876,1,1.0,0.0,13,0,13
Alboteaparty,0,0.562099328202945,0.4379006717970551,1,1.0,0.0,7,0,7
alexdelong_,1,0.13840205656991422,0.8615979434300858,1,1.0,0.0,1,0,1
AllanLohr,0,0.6190620822684955,0.38093791773150454,1,1.0,0.0,3,0,3
allisonnell,0,0.7323905385680839,0.2676094614319161,-1,0.0,1.0,0,4,4
amyrpatton,1,0.2307460187355015,0.7692539812644985,1,0.970588235,0.029411765,33,1,34
AngelaFairbanks,0,0.7075386477756236,0.29246135222437647,1,1.0,0.0,14,0,14
anj_90,0,0.5573443577642879,0.4426556422357121,-1,0.0,1.0,0,13,13
annamchughGP,0,0.8237839270811895,0.1762160729188105,-1,0.0,1.0,0,3,3
anscott63,0,0.6409520020970609,0.359047997902939,1,1.0,0.0,1,0,1
Anthony13JJ,0,0.6198847650363051,0.380115234963695,-1,0.0,1.0,0,9,9
Apocalypte,0,0.8249843513798867,0.1750156486201133,-1,0.0,1.0,0,8,8
AustCBR,1,0.08139944445449543,0.9186005555455046,1,1.0,0.0,10,0,10
bakerbarb54130,1,0.2849973862966564,0.7150026137033436,1,1.0,0.0,7,0,7
bananafitz,0,0.7111269380012529,0.28887306199874707,-1,0.0,1.0,0,1,1
basvandervoort,0,0.6085849640663457,0.3914150359336543,1,1.0,0.0,1,0,1
beckererine,0,0.7282365807243609,0.271763419275639,-1,0.0,1.0,0,3,3
BeWellWriting,0,0.6606301664588141,0.3393698335411859,-1,0.0,1.0,0,7,7
BitterBrendy,0,0.6711579405460713,0.32884205945392875,-1,0.0,1.0,0,2,2
bo_rajer,0,0.6190620822684955,0.38093791773150454,-1,0.666666667,0.333333333,2,1,3
braincavanagh,0,0.7625441075234958,0.23745589247650423,-1,0.0,1.0,0,5,5
BrianChiasson,0,0.568623955652696,0.43137604434730403,1,1.0,0.0,9,0,9
Briggs_CK,0,0.6190620822684955,0.38093791773150454,-1,0.0,1.0,0,1,1
BundeCollins,0,0.6052353054384108,0.3947646945615893,-1,0.0,1.0,0,1,1
caraecal,0,0.8099474137461878,0.19005258625381213,1,0.0,1.0,0,21,21
CaRi1765,0,0.6420665934874092,0.3579334065125908,1,0.0,0.0,0,0,0
CathCornellMD,0,0.7251196743183352,0.2748803256816648,-1,0.0,1.0,0,2,2
CathrynBuse,1,0.37995943114157227,0.6200405688584277,1,1.0,0.0,2,0,2
cbpolis,0,0.7616916455886404,0.23830835441135959,-1,0.0,1.0,0,15,15
CDGonzo2016,1,0.25363241157206506,0.7463675884279349,1,1.0,0.0,4,0,4
ch7pg3,0,0.6642515980192973,0.3357484019807026,-1,0.0,1.0,0,8,8
Chuck_Swanson,1,0.32746028522409654,0.6725397147759035,1,1.0,0.0,14,0,14
CityonaHillUSA,0,0.5768212552982906,0.42317874470170935,1,1.0,0.0,2,0,2
clayguy83,0,0.5753398585107927,0.4246601414892073,1,1.0,0.0,1,0,1
ClevelandRTL,1,0.40104453793174666,0.5989554620682533,1,1.0,0.0,16,0,16
clinicalsarcasm,0,0.6084196342309338,0.39158036576906613,-1,0.0,1.0,0,1,1
ClymerCaitlyn,0,0.6979901578209693,0.30200984217903076,-1,0.0,1.0,0,1,1
ConnieBII,1,0.11391184792017095,0.886088152079829,1,1.0,0.0,11,0,11
cpsmurtagh,0,0.7550262178186207,0.24497378218137927,-1,0.0,1.0,0,2,2
CSLCHSnMore,0,0.6525887441211082,0.3474112558788917,1,1.0,0.0,3,0,3
DailyCatechist,1,0.17085188220164615,0.8291481177983538,1,1.0,0.0,13,0,13
DAvallone,0,0.7724888551380122,0.22751114486198773,-1,0.0,1.0,0,2,2
debc51,1,0.21174082933759764,0.7882591706624024,1,0.9642857140000001,0.035714286,27,1,28
defenderofthe8,0,0.8237839270811895,0.1762160729188105,1,1.0,0.0,20,0,20
denmurray24,0,0.738953348474894,0.2610466515251059,-1,0.0,1.0,0,3,3
DenverDelRay,0,0.6214569437862798,0.37854305621372014,-1,0.0,1.0,0,1,1
derrickj2015,0,0.6349963023700855,0.3650036976299144,1,1.0,0.0,1,0,1
DianaMurtagh,0,0.6452970329848574,0.3547029670151426,-1,0.0,1.0,0,1,1
digingupthedead,0,0.5536002913910728,0.4463997086089272,1,1.0,0.0,1,0,1
Disciple4Lif,0,0.5321891796022307,0.4678108203977693,1,1.0,0.0,9,0,9
dogsharkey,0,0.7260005875855945,0.2739994124144055,-1,0.0,1.0,0,1,1
donbrownbooks,0,0.5477181785953941,0.45228182140460593,1,1.0,0.0,1,0,1
DrCNM,0,0.7501926972624888,0.24980730273751123,-1,0.0,1.0,0,8,8
DrEmmaBasch,0,0.6190620822684955,0.38093791773150454,-1,0.0,1.0,0,2,2
ebethsher,0,0.6190620822684955,0.38093791773150454,1,1.0,0.0,2,0,2
eleenmurf,0,0.6190620822684955,0.38093791773150454,-1,0.0,1.0,0,4,4
Elentari98,0,0.6541019734181418,0.3458980265818582,1,1.0,0.0,4,0,4
EmilyThrive,0,0.6941880757082204,0.3058119242917796,-1,0.0,1.0,0,1,1
ericzieg,0,0.6976524992384563,0.3023475007615437,-1,0.0,1.0,0,1,1
evonniastarr,0,0.7497750839714958,0.2502249160285041,1,1.0,0.0,2,0,2
farfromhomenow,0,0.6190620822684955,0.38093791773150454,1,1.0,0.0,1,0,1
fargen77,1,0.46837839457939634,0.5316216054206037,1,1.0,0.0,4,0,4
fedewa_agnes,1,0.15993339147097252,0.8400666085290275,1,0.9411764709999999,0.058823529000000006,16,1,17
ffskennz,0,0.8356075309521004,0.16439246904789961,-1,0.0,1.0,0,5,5
formasjuitan,0,0.5814442185682089,0.418555781431791,-1,0.0,1.0,0,3,3
frederick5661,1,0.1732680315916033,0.8267319684083967,1,1.0,0.0,15,0,15
FreeSafeLegalUK,0,0.8197084515864648,0.18029154841353529,-1,0.214285714,0.7857142859999999,3,11,14
FriscoTx4Trump,1,0.32471920410435495,0.675280795895645,1,1.0,0.0,14,0,14
GaryMillrat,0,0.7006858170309097,0.2993141829690903,-1,0.0,1.0,0,3,3
GermanAlcocer1,0,0.6190620822684955,0.38093791773150454,-1,0.0,1.0,0,5,5
grammaviolet,0,0.761433359229681,0.23856664077031894,-1,0.0,1.0,0,10,10
Great_Scott79,0,0.5104973247619055,0.48950267523809454,1,1.0,0.0,9,0,9
HattieLadd,0,0.8736442659003665,0.12635573409963347,-1,0.0,1.0,0,12,12
HopeBeats,1,0.26621174590580166,0.7337882540941983,1,1.0,0.0,20,0,20
Hweininger,1,0.08364304605217776,0.9163569539478222,1,0.9642857140000001,0.035714286,27,1,28
ibiloh,1,0.13820537902506547,0.8617946209749345,-1,0.0,1.0,0,1,1
IbrahimSaidUba1,0,0.6131719386048706,0.3868280613951294,-1,0.0,1.0,0,1,1
inarvan,0,0.6473147699862454,0.35268523001375457,-1,0.0,1.0,0,1,1
IWRising,0,0.728994918637377,0.27100508136262297,-1,0.0,1.0,0,8,8
Jaack2063,1,0.14565747582679744,0.8543425241732026,1,1.0,0.0,1,0,1
jackeekgonzalez,1,0.14827363162727614,0.8517263683727239,1,0.9375,0.0625,15,1,16
jessicapcash87,0,0.688317183450438,0.31168281654956204,1,0.0,1.0,0,3,3
jessiechavez491,0,0.6190620822684955,0.38093791773150454,-1,0.0,1.0,0,1,1
JessieQ_1,1,0.10113532101364253,0.8988646789863575,1,0.96969697,0.03030303,32,1,33
JeSuisAlison,0,0.6319010526000749,0.3680989473999251,-1,0.0,1.0,0,1,1
jhiybqh3,0,0.6190620822684955,0.38093791773150454,1,1.0,0.0,2,0,2
JobsenGrothe,0,0.6078064821567781,0.3921935178432218,1,1.0,0.0,1,0,1
Joe_Panama,0,0.8263444593225222,0.17365554067747785,-1,0.0,1.0,0,2,2
johng167,0,0.6233361219639368,0.37666387803606316,1,1.0,0.0,1,0,1
johnphalpin,0,0.7042269554762954,0.2957730445237046,-1,0.0,1.0,0,1,1
joleen_jkane27,0,0.6190620822684955,0.38093791773150454,-1,0.0,1.0,0,2,2
josephintoronto,0,0.6410078079014268,0.3589921920985732,1,1.0,0.0,1,0,1
JPAndreas1,1,0.28043478316479353,0.7195652168352065,1,1.0,0.0,7,0,7
jshaw423,0,0.694318346071666,0.305681653928334,-1,0.0,1.0,0,4,4
juliana_swenson,0,0.6301444632324629,0.36985553676753713,-1,0.0,1.0,0,1,1
julieburtonwmc,0,0.8397188623248327,0.1602811376751673,-1,0.0,1.0,0,6,6
justaoifethings,0,0.8380842097539231,0.16191579024607697,-1,0.0,1.0,0,4,4
justinbook18,0,0.5617163085704239,0.4382836914295761,1,1.0,0.0,9,0,9
JVanMaren,1,0.18573511161960532,0.8142648883803947,1,0.9,0.1,18,2,20
katherine_ae,0,0.7446728812516026,0.2553271187483975,-1,0.0,1.0,0,6,6
katie_jacob55,1,0.26770048318344586,0.7322995168165541,-1,0.8888888890000001,0.111111111,8,1,9
KatLTosh,0,0.7018094270833177,0.29819057291668233,-1,0.0,1.0,0,1,1
Keithhinton8,1,0.16918994741987126,0.8308100525801287,1,1.0,0.0,12,0,12
kelseamcbelsea,0,0.7353043795590362,0.2646956204409639,1,0.0,1.0,0,21,21
KGHerriott23,0,0.6190620822684955,0.38093791773150454,1,1.0,0.0,1,0,1
kgscanlon,0,0.5374626881992921,0.46253731180070784,1,0.923076923,0.076923077,12,1,13
kimidwa,0,0.5692020030969833,0.43079799690301673,1,1.0,0.0,3,0,3
Klaskarides,0,0.6303908686175116,0.3696091313824884,-1,0.0,1.0,0,1,1
KmTilley,1,0.41138637381721077,0.5886136261827892,-1,0.0,1.0,0,4,4
laurelmoth,0,0.6407313764243541,0.3592686235756459,-1,0.0,1.0,0,4,4
lifepathMAS,1,0.16969819060232827,0.8303018093976717,1,1.0,0.0,3,0,3
likallman,0,0.7720218180749364,0.22797818192506358,-1,0.0,1.0,0,1,1
Linzito85,0,0.6341982838574991,0.36580171614250084,1,0.0,0.0,0,0,0
littlemissevec,0,0.6468050339163546,0.3531949660836454,-1,0.0,1.0,0,7,7
Lizard_UK,0,0.5831440347632113,0.41685596523678875,1,1.0,0.0,1,0,1
LizYohnRN,0,0.7524640325633871,0.24753596743661285,-1,0.0,1.0,0,17,17
LoriDeForest62,0,0.6198847650363051,0.380115234963695,-1,0.0,1.0,0,1,1
LuiGui_FCh,1,0.4990200969200319,0.5009799030799681,1,0.5,0.5,1,1,2
lwsplash,0,0.7018351957793572,0.29816480422064284,-1,0.0,1.0,0,2,2
madelbean,0,0.6955708044451281,0.3044291955548719,-1,0.0,1.0,0,3,3
Manuela2day,1,0.1042688574148819,0.8957311425851181,1,0.833333333,0.166666667,5,1,6
margorice86,0,0.700752827473476,0.29924717252652394,-1,0.0,1.0,0,1,1
marthahorton2,0,0.607334142904435,0.392665857095565,1,1.0,0.0,1,0,1
mikealfinito,1,0.3422868551638705,0.6577131448361295,1,1.0,0.0,1,0,1
MikeMorganMN,0,0.6190620822684955,0.38093791773150454,1,1.0,0.0,1,0,1
misbehavens,0,0.6125458080409016,0.3874541919590984,1,1.0,0.0,4,0,4
miskinlaw,0,0.6976956245738584,0.3023043754261416,-1,0.0,1.0,0,5,5
miss_kGa,1,0.42720021184645596,0.572799788153544,1,0.875,0.125,7,1,8
Miss_Sam_Kelly,0,0.6190620822684955,0.38093791773150454,1,1.0,0.0,1,0,1
MJLucey,0,0.6717381455812267,0.3282618544187733,-1,0.0,1.0,0,2,2
molly_trivette,1,0.4211006511261959,0.5788993488738041,1,1.0,0.0,6,0,6
MonetteStephen,1,0.31083834325477744,0.6891616567452226,1,1.0,0.0,17,0,17
Morgan0livia,0,0.6056332338312473,0.39436676616875266,-1,0.0,1.0,0,1,1
Mr_TomMyers,0,0.6888473119911901,0.3111526880088099,-1,0.0,1.0,0,1,1
MrsDoma,1,0.15646877898857614,0.8435312210114239,1,0.944444444,0.055555556,17,1,18
Muir_maid,0,0.8308528630424064,0.16914713695759367,-1,0.0,1.0,0,3,3
okinnear3,0,0.7200655536289388,0.27993444637106124,-1,0.0,1.0,0,1,1
OnlyGirlOfTen,1,0.20886114885996487,0.7911388511400351,1,0.9375,0.0625,15,1,16
PatKernanQuinn,0,0.5214849871952277,0.47851501280477227,-1,0.875,0.125,7,1,8
Pearl_Barney,0,0.638772465518824,0.3612275344811759,1,0.0,0.0,0,0,0
PeterJohnRowe,1,0.43138291288117603,0.568617087118824,1,1.0,0.0,2,0,2
ProfHarlan,0,0.6894750187430405,0.31052498125695943,-1,0.0,1.0,0,1,1
Prolifefriend,1,0.08205509214930529,0.9179449078506947,1,0.96875,0.03125,31,1,32
rabbrady,1,0.20134563863411226,0.7986543613658877,1,1.0,0.0,4,0,4
realsophieyates,0,0.7076882980944864,0.2923117019055136,-1,0.0,1.0,0,3,3
RebeccaG2012,1,0.22719505115566652,0.7728049488443335,1,1.0,0.0,4,0,4
RedPillSlayer,0,0.6231107928498232,0.37688920715017676,1,0.0,0.0,0,0,0
regright,0,0.5564830610748086,0.44351693892519145,1,1.0,0.0,1,0,1
ReinyDey,1,0.09367903863698446,0.9063209613630155,1,0.954545455,0.045454545,21,1,22
RepMyers,0,0.667925755317492,0.33207424468250807,-1,0.0,1.0,0,3,3
richard_bushey,1,0.2070137762129639,0.7929862237870361,1,1.0,0.0,2,0,2
richellenicole,0,0.6045839727777231,0.3954160272222769,-1,0.0,1.0,0,1,1
riconservative,0,0.5465280024976548,0.45347199750234524,1,1.0,0.0,5,0,5
rjg27,0,0.6292103427050699,0.37078965729493013,1,1.0,0.0,1,0,1
RKCSouthern,0,0.6155601528883585,0.3844398471116415,1,1.0,0.0,1,0,1
RockBautumn,0,0.7000462927606441,0.2999537072393558,-1,0.0,1.0,0,1,1
Rodrigo_Bares,0,0.6514893476047876,0.3485106523952124,-1,0.0,1.0,0,1,1
RooForLife,1,0.16198648473631772,0.8380135152636823,1,0.96969697,0.03030303,32,1,33
RoseAntonia13,0,0.6886600744802753,0.3113399255197247,-1,0.0,1.0,0,2,2
RoxieToxic_,0,0.6888473119911901,0.3111526880088099,-1,0.0,1.0,0,11,11
RyanBizarri,1,0.19028707709228232,0.8097129229077177,1,1.0,0.0,11,0,11
samscrta,0,0.6880616008344755,0.3119383991655244,-1,0.0,1.0,0,2,2
SamuelRWeaver1,1,0.0944933789567356,0.9055066210432644,1,1.0,0.0,3,0,3
scarr6612,0,0.5692594311711546,0.43074056882884537,-1,0.875,0.125,7,1,8
scopferbrace,0,0.6753680332922496,0.3246319667077504,-1,0.0,1.0,0,1,1
sexualhealthns,0,0.8083804471279625,0.19161955287203747,-1,0.0,1.0,0,9,9
shaunkenyon1967,0,0.6190620822684955,0.38093791773150454,-1,0.0,1.0,0,6,6
SheriTreadwell,0,0.6686486227432645,0.33135137725673547,1,1.0,0.0,2,0,2
ShinobiShawn2,0,0.6234816226489333,0.3765183773510667,1,1.0,0.0,2,0,2
ShooguhLipz,0,0.7068336785929024,0.2931663214070977,-1,0.0,1.0,0,8,8
SimonCookeMSI,0,0.6960777836443763,0.3039222163556237,-1,0.0,1.0,0,5,5
sineadgallivann,0,0.6066324566600397,0.39336754333996027,-1,0.0,0.0,0,0,0
soihadanabort,0,0.5741843192962,0.4258156807038,-1,0.05,0.95,1,19,20
sojourner_blanc,0,0.6529168334150142,0.34708316658498584,-1,0.0,1.0,0,2,2
strangemoore,0,0.7161354210039077,0.28386457899609235,-1,0.0,1.0,0,1,1
sydneyrenee3,0,0.5573339157849795,0.4426660842150205,-1,0.0,1.0,0,1,1
T2theGuajardo,1,0.2895150037359172,0.7104849962640828,1,1.0,0.0,5,0,5
The_Alma_D,0,0.6242634801142566,0.3757365198857434,-1,0.0,1.0,0,13,13
thejacksonlacy,0,0.6811458527151798,0.3188541472848202,-1,0.0,1.0,0,1,1
thejessicaraven,0,0.7335185505428978,0.2664814494571022,-1,0.25,0.75,1,3,4
TheOpenMicah,0,0.597680182265595,0.4023198177344049,1,1.0,0.0,2,0,2
tideslifefaith,1,0.27620102288691484,0.7237989771130852,1,1.0,0.0,4,0,4
tjbayus1,0,0.6173018034795348,0.38269819652046516,1,1.0,0.0,1,0,1
tkose98,0,0.6643204865146398,0.3356795134853602,-1,0.0,1.0,0,1,1
TomBurdolski,1,0.15770058645954432,0.8422994135404557,1,1.0,0.0,11,0,11
toratannerchung,0,0.7211504556995281,0.278849544300472,-1,0.0,1.0,0,1,1
Trevor_Horne,0,0.6643551854109339,0.33564481458906614,-1,0.0,1.0,0,1,1
trianglescheme,0,0.6907768099051859,0.3092231900948141,-1,0.0,1.0,0,7,7
turnerdina1,1,0.3247833152477012,0.6752166847522988,1,1.0,0.0,4,0,4
UKStorageGuru,0,0.6190620822684955,0.38093791773150454,1,1.0,0.0,1,0,1
vailkoyo,0,0.6367200592539618,0.3632799407460382,-1,0.0,1.0,0,2,2
VERASTEGUI100,1,0.10527305970081413,0.8947269402991859,1,0.947368421,0.052631579000000005,18,1,19
Vikar_Singh,0,0.6656307157821908,0.33436928421780915,-1,0.0,1.0,0,2,2
VLabarum,1,0.4383623424716392,0.5616376575283608,1,0.923076923,0.076923077,12,1,13
wafulkerson1,0,0.6066324566600397,0.39336754333996027,1,1.0,0.0,2,0,2
WarrenDavidson,1,0.24393979980301217,0.7560602001969878,1,0.9,0.1,9,1,10
WilsonRx,1,0.38081549133840875,0.6191845086615912,1,1.0,0.0,3,0,3
wordspurify27,0,0.5714097010471764,0.4285902989528237,-1,0.0,1.0,0,3,3
