account_name,predict_class,prochoice_strength,prolife_strength,follower of,prolife proportion,prochoice proportion,prolife cnt,prochoice cnt,total cnt
ABabysRights,1,0.10033574334685613,0.8996642566531439,1,1.0,0.0,12,0,12
ABGYNservices,0,0.6464052077397383,0.3535947922602617,-1,0.0,1.0,0,9,9
Abigailschumach,1,0.2892979754968086,0.7107020245031914,1,1.0,0.0,13,0,13
Alboteaparty,0,0.5549452698853582,0.4450547301146418,1,1.0,0.0,7,0,7
alexdelong_,1,0.13920900768935174,0.8607909923106483,1,1.0,0.0,1,0,1
AllanLohr,0,0.6132019112345195,0.38679808876548055,1,1.0,0.0,3,0,3
allisonnell,0,0.7110505355703648,0.2889494644296352,-1,0.0,1.0,0,4,4
amyrpatton,1,0.22556768332034105,0.774432316679659,1,0.9705882352941176,0.029411764705882356,33,1,34
AngelaFairbanks,0,0.6797251542623725,0.32027484573762754,1,1.0,0.0,14,0,14
anj_90,0,0.5532281507874318,0.4467718492125682,-1,0.0,1.0,0,13,13
annamchughGP,0,0.8216759809411317,0.1783240190588683,-1,0.0,1.0,0,3,3
anscott63,0,0.6142142894801952,0.38578571051980476,1,1.0,0.0,1,0,1
Anthony13JJ,0,0.5994989537029674,0.4005010462970326,-1,0.0,1.0,0,9,9
Apocalypte,0,0.8213603146097883,0.1786396853902117,-1,0.0,1.0,0,8,8
AustCBR,1,0.0854776323949683,0.9145223676050317,1,1.0,0.0,10,0,10
bakerbarb54130,1,0.2881883238003108,0.7118116761996892,1,1.0,0.0,7,0,7
bananafitz,0,0.7134905727556938,0.28650942724430617,-1,0.0,1.0,0,1,1
basvandervoort,0,0.5919523947606085,0.4080476052393915,1,1.0,0.0,1,0,1
beckererine,0,0.7210571104059948,0.27894288959400515,-1,0.0,1.0,0,3,3
BeWellWriting,0,0.6445955022937836,0.3554044977062164,-1,0.0,1.0,0,7,7
BitterBrendy,0,0.6731867385550439,0.3268132614449561,-1,0.0,1.0,0,2,2
bo_rajer,0,0.6132019112345195,0.38679808876548055,-1,0.6666666666666666,0.3333333333333333,2,1,3
braincavanagh,0,0.7598951679428568,0.24010483205714314,-1,0.0,1.0,0,5,5
BrianChiasson,0,0.56298148254796,0.43701851745204,1,1.0,0.0,9,0,9
Briggs_CK,0,0.6132019112345195,0.38679808876548055,-1,0.0,1.0,0,1,1
BundeCollins,0,0.599276781102138,0.400723218897862,-1,0.0,1.0,0,1,1
caraecal,0,0.7974353235507329,0.20256467644926715,1,0.045454545454545456,0.9545454545454546,1,21,22
CaRi1765,0,0.6237324806469708,0.3762675193530292,1,1.0,0.0,1,0,1
CathCornellMD,0,0.715056303548741,0.284943696451259,-1,0.0,1.0,0,2,2
CathrynBuse,1,0.3751460604298521,0.6248539395701479,1,1.0,0.0,2,0,2
cbpolis,0,0.7387895673183327,0.26121043268166727,-1,0.0,1.0,0,15,15
CDGonzo2016,1,0.25783094989576416,0.7421690501042358,1,1.0,0.0,4,0,4
ch7pg3,0,0.6634990958529563,0.33650090414704364,-1,0.0,1.0,0,8,8
Chuck_Swanson,1,0.3298431103002317,0.6701568896997683,1,1.0,0.0,14,0,14
CityonaHillUSA,0,0.5726125415964782,0.42738745840352177,1,1.0,0.0,2,0,2
clayguy83,0,0.5585145210663646,0.44148547893363543,1,1.0,0.0,1,0,1
ClevelandRTL,1,0.3998972488802426,0.6001027511197574,1,1.0,0.0,16,0,16
clinicalsarcasm,0,0.6028575455292801,0.39714245447071994,-1,0.0,1.0,0,1,1
ClymerCaitlyn,0,0.6950031501592611,0.30499684984073894,-1,0.0,1.0,0,1,1
ConnieBII,1,0.11703505341718323,0.8829649465828168,1,1.0,0.0,11,0,11
cpsmurtagh,0,0.748909592257677,0.2510904077423231,-1,0.0,1.0,0,2,2
CSLCHSnMore,0,0.6524608178649317,0.3475391821350683,1,1.0,0.0,3,0,3
DailyCatechist,1,0.17581507185287093,0.8241849281471291,1,1.0,0.0,13,0,13
DAvallone,0,0.7532071165915404,0.24679288340845962,-1,0.0,1.0,0,2,2
debc51,1,0.21093369372022575,0.7890663062797743,1,0.9642857142857144,0.03571428571428571,27,1,28
defenderofthe8,0,0.8216759809411317,0.1783240190588683,1,1.0,0.0,20,0,20
denmurray24,0,0.7369087352580139,0.2630912647419861,-1,0.0,1.0,0,3,3
DenverDelRay,0,0.6180183180541722,0.3819816819458278,-1,0.0,1.0,0,1,1
derrickj2015,0,0.6217664352377411,0.3782335647622589,1,1.0,0.0,1,0,1
DianaMurtagh,0,0.6417846504827206,0.3582153495172794,-1,0.0,1.0,0,1,1
digingupthedead,0,0.5400557234955845,0.4599442765044155,1,1.0,0.0,1,0,1
Disciple4Lif,0,0.5241077787193493,0.4758922212806506,1,1.0,0.0,9,0,9
dogsharkey,0,0.7207914630681911,0.2792085369318089,-1,0.0,1.0,0,1,1
donbrownbooks,0,0.5411531225200035,0.4588468774799966,1,1.0,0.0,1,0,1
DrCNM,0,0.7436145390929408,0.25638546090705916,-1,0.0,1.0,0,8,8
DrEmmaBasch,0,0.6132019112345195,0.38679808876548055,-1,0.0,1.0,0,2,2
ebethsher,0,0.6132019112345195,0.38679808876548055,1,1.0,0.0,2,0,2
eleenmurf,0,0.6132019112345195,0.38679808876548055,-1,0.0,1.0,0,4,4
Elentari98,0,0.6464044066143088,0.35359559338569124,1,1.0,0.0,4,0,4
EmilyThrive,0,0.6828105920921732,0.3171894079078268,-1,0.0,1.0,0,1,1
ericzieg,0,0.6925633800707232,0.3074366199292769,-1,0.0,1.0,0,1,1
evonniastarr,0,0.7430864841224738,0.2569135158775262,1,1.0,0.0,2,0,2
farfromhomenow,0,0.6132019112345195,0.38679808876548055,1,1.0,0.0,1,0,1
fargen77,1,0.47127793078111113,0.5287220692188889,1,1.0,0.0,4,0,4
fedewa_agnes,1,0.16371861635356189,0.8362813836464381,1,0.9411764705882352,0.05882352941176471,16,1,17
ffskennz,0,0.8335278348020259,0.16647216519797411,-1,0.0,1.0,0,5,5
formasjuitan,0,0.578783467561218,0.42121653243878193,-1,0.0,1.0,0,3,3
frederick5661,1,0.17626291151523943,0.8237370884847606,1,1.0,0.0,15,0,15
FreeSafeLegalUK,0,0.8012898251130797,0.19871017488692036,-1,0.21428571428571427,0.7857142857142857,3,11,14
FriscoTx4Trump,1,0.3196949937059923,0.6803050062940077,1,1.0,0.0,14,0,14
GaryMillrat,0,0.6781448450340463,0.32185515496595374,-1,0.0,1.0,0,3,3
GermanAlcocer1,0,0.6132019112345195,0.38679808876548055,-1,0.0,1.0,0,5,5
grammaviolet,0,0.7389535765184231,0.2610464234815769,-1,0.0,1.0,0,10,10
Great_Scott79,0,0.5002258655577452,0.49977413444225477,1,1.0,0.0,9,0,9
HattieLadd,0,0.8688781234473714,0.13112187655262864,-1,0.0,1.0,0,12,12
HopeBeats,1,0.2629967281647806,0.7370032718352194,1,1.0,0.0,20,0,20
Hweininger,1,0.08774243986200858,0.9122575601379914,1,0.9642857142857144,0.03571428571428571,27,1,28
ibiloh,1,0.14165372607339966,0.8583462739266003,-1,0.0,1.0,0,1,1
IbrahimSaidUba1,0,0.6081128224402617,0.3918871775597383,-1,0.0,1.0,0,1,1
inarvan,0,0.6271389665573001,0.37286103344269994,-1,0.0,1.0,0,1,1
IWRising,0,0.7209773142214053,0.27902268577859474,-1,0.0,1.0,0,8,8
Jaack2063,1,0.14831072450416427,0.8516892754958357,1,1.0,0.0,1,0,1
jackeekgonzalez,1,0.15034542465640743,0.8496545753435926,1,0.9375,0.0625,15,1,16
jessicapcash87,0,0.6900963999023706,0.3099036000976294,1,0.0,1.0,0,3,3
jessiechavez491,0,0.6132019112345195,0.38679808876548055,-1,0.0,1.0,0,1,1
JessieQ_1,1,0.10629197343414709,0.8937080265658529,1,0.9696969696969696,0.030303030303030307,32,1,33
JeSuisAlison,0,0.6285553921640014,0.37144460783599864,-1,0.0,1.0,0,1,1
jhiybqh3,0,0.6132019112345195,0.38679808876548055,1,1.0,0.0,2,0,2
JobsenGrothe,0,0.6014338937490706,0.3985661062509293,1,1.0,0.0,1,0,1
Joe_Panama,0,0.8246735333426578,0.17532646665734217,-1,0.0,1.0,0,2,2
johng167,0,0.6080577337148261,0.39194226628517387,1,1.0,0.0,1,0,1
johnphalpin,0,0.7046564085405591,0.29534359145944095,-1,0.0,1.0,0,1,1
joleen_jkane27,0,0.6132019112345195,0.38679808876548055,-1,0.0,1.0,0,2,2
josephintoronto,0,0.6347483640972316,0.36525163590276843,1,1.0,0.0,1,0,1
JPAndreas1,1,0.27618779408162364,0.7238122059183764,1,1.0,0.0,7,0,7
jshaw423,0,0.696174234098188,0.30382576590181204,-1,0.0,1.0,0,4,4
juliana_swenson,0,0.6123726323863945,0.38762736761360556,-1,0.0,1.0,0,1,1
julieburtonwmc,0,0.8212937368908906,0.1787062631091094,-1,0.0,1.0,0,6,6
justaoifethings,0,0.8379019691826501,0.1620980308173499,-1,0.0,1.0,0,4,4
justinbook18,0,0.5537082408903917,0.44629175910960833,1,1.0,0.0,9,0,9
JVanMaren,1,0.18165709478144176,0.8183429052185582,1,0.9,0.1,18,2,20
katherine_ae,0,0.7249266585271559,0.27507334147284407,-1,0.0,1.0,0,6,6
katie_jacob55,1,0.271567839438174,0.728432160561826,-1,0.8888888888888888,0.1111111111111111,8,1,9
KatLTosh,0,0.6986582577388067,0.30134174226119326,-1,0.0,1.0,0,1,1
Keithhinton8,1,0.17099915490977313,0.8290008450902269,1,1.0,0.0,12,0,12
kelseamcbelsea,0,0.7089224870437577,0.2910775129562423,1,0.045454545454545456,0.9545454545454546,1,21,22
KGHerriott23,0,0.6132019112345195,0.38679808876548055,1,1.0,0.0,1,0,1
kgscanlon,0,0.5352081765592258,0.46479182344077413,1,0.9230769230769232,0.07692307692307693,12,1,13
kimidwa,0,0.5550668246697417,0.4449331753302583,1,1.0,0.0,3,0,3
Klaskarides,0,0.6259603432066447,0.3740396567933552,-1,0.0,1.0,0,1,1
KmTilley,1,0.41171625057511385,0.5882837494248861,-1,0.0,1.0,0,4,4
laurelmoth,0,0.6465995735642294,0.35340042643577063,-1,0.0,1.0,0,4,4
lifepathMAS,1,0.1737496285554262,0.8262503714445738,1,1.0,0.0,3,0,3
likallman,0,0.7411420439384123,0.2588579560615877,-1,0.0,1.0,0,1,1
Linzito85,0,0.6316550406941799,0.36834495930582006,1,0.0,0.0,0,0,0
littlemissevec,0,0.64066098004813,0.35933901995186995,-1,0.0,1.0,0,7,7
Lizard_UK,0,0.576846360287716,0.42315363971228404,1,1.0,0.0,1,0,1
LizYohnRN,0,0.6906402717646356,0.3093597282353644,-1,0.0,1.0,0,17,17
LoriDeForest62,0,0.5994989537029674,0.4005010462970326,-1,0.0,1.0,0,1,1
LuiGui_FCh,1,0.4941091793354404,0.5058908206645596,1,0.5,0.5,1,1,2
lwsplash,0,0.685584019242736,0.314415980757264,-1,0.0,1.0,0,2,2
madelbean,0,0.6790231036428256,0.32097689635717447,-1,0.0,1.0,0,3,3
Manuela2day,1,0.10720045598330352,0.8927995440166965,1,0.8333333333333334,0.16666666666666666,5,1,6
margorice86,0,0.6955323339833621,0.30446766601663783,-1,0.0,1.0,0,1,1
marthahorton2,0,0.591067038568471,0.408932961431529,1,1.0,0.0,1,0,1
mikealfinito,1,0.3347286631760261,0.6652713368239739,1,1.0,0.0,1,0,1
MikeMorganMN,0,0.6132019112345195,0.38679808876548055,1,1.0,0.0,1,0,1
misbehavens,0,0.6035019009870553,0.3964980990129447,1,1.0,0.0,4,0,4
miskinlaw,0,0.6985934170778729,0.3014065829221271,-1,0.0,1.0,0,5,5
miss_kGa,1,0.42843899726896195,0.571561002731038,1,0.875,0.125,7,1,8
Miss_Sam_Kelly,0,0.6132019112345195,0.38679808876548055,1,1.0,0.0,1,0,1
MJLucey,0,0.6703656276056089,0.3296343723943911,-1,0.0,1.0,0,2,2
molly_trivette,1,0.42402295578041294,0.5759770442195871,1,1.0,0.0,6,0,6
MonetteStephen,1,0.30531105921161783,0.6946889407883822,1,1.0,0.0,17,0,17
Morgan0livia,0,0.600146930317359,0.39985306968264106,-1,0.0,1.0,0,1,1
Mr_TomMyers,0,0.6917468618493733,0.3082531381506267,-1,0.0,1.0,0,1,1
MrsDoma,1,0.1602862655327616,0.8397137344672384,1,0.9444444444444444,0.05555555555555555,17,1,18
Muir_maid,0,0.82908460441136,0.17091539558864005,-1,0.0,1.0,0,3,3
okinnear3,0,0.7135575899839953,0.2864424100160047,-1,0.0,1.0,0,1,1
OnlyGirlOfTen,1,0.20647417321709427,0.7935258267829057,1,0.9375,0.0625,15,1,16
PatKernanQuinn,0,0.5203130266359466,0.4796869733640534,-1,0.875,0.125,7,1,8
Pearl_Barney,0,0.6347574647914884,0.3652425352085116,1,1.0,0.0,1,0,1
PeterJohnRowe,1,0.429741335352277,0.570258664647723,1,1.0,0.0,2,0,2
ProfHarlan,0,0.6851215561593031,0.3148784438406968,-1,0.0,1.0,0,1,1
Prolifefriend,1,0.08598572933842374,0.9140142706615763,1,0.96875,0.03125,31,1,32
rabbrady,1,0.20713027744386836,0.7928697225561316,1,1.0,0.0,4,0,4
realsophieyates,0,0.7093283702429223,0.2906716297570777,-1,0.0,1.0,0,3,3
RebeccaG2012,1,0.23175626123873172,0.7682437387612683,1,1.0,0.0,4,0,4
RedPillSlayer,0,0.6040276980677284,0.3959723019322716,1,0.0,0.0,0,0,0
regright,0,0.5480093327437954,0.4519906672562047,1,1.0,0.0,1,0,1
ReinyDey,1,0.09776595480133332,0.9022340451986667,1,0.9545454545454546,0.045454545454545456,21,1,22
RepMyers,0,0.6493891961140142,0.35061080388598576,-1,0.0,1.0,0,3,3
richard_bushey,1,0.2092815207894787,0.7907184792105213,1,1.0,0.0,2,0,2
richellenicole,0,0.5982432869880268,0.4017567130119733,-1,0.0,1.0,0,1,1
riconservative,0,0.5414393146601351,0.458560685339865,1,1.0,0.0,5,0,5
rjg27,0,0.6234459471734812,0.3765540528265188,1,1.0,0.0,1,0,1
RKCSouthern,0,0.6101272303493863,0.38987276965061374,1,1.0,0.0,1,0,1
RockBautumn,0,0.68343207394652,0.31656792605348005,-1,0.0,1.0,0,1,1
Rodrigo_Bares,0,0.648760481672023,0.35123951832797695,-1,0.0,1.0,0,1,1
RooForLife,1,0.16399105012790294,0.8360089498720971,1,0.9696969696969696,0.030303030303030307,32,1,33
RoseAntonia13,0,0.6863546452021745,0.3136453547978255,-1,0.0,1.0,0,2,2
RoxieToxic_,0,0.6917468618493733,0.3082531381506267,-1,0.0,1.0,0,11,11
RyanBizarri,1,0.1950273347037368,0.8049726652962632,1,1.0,0.0,11,0,11
samscrta,0,0.6871478764310965,0.3128521235689035,-1,0.0,1.0,0,2,2
SamuelRWeaver1,1,0.09741382523493236,0.9025861747650676,1,1.0,0.0,3,0,3
scarr6612,0,0.5633752076685147,0.4366247923314853,-1,0.875,0.125,7,1,8
scopferbrace,0,0.6745453779623467,0.3254546220376533,-1,0.0,1.0,0,1,1
sexualhealthns,0,0.8031979253743661,0.1968020746256339,-1,0.0,1.0,0,9,9
shaunkenyon1967,0,0.6132019112345195,0.38679808876548055,-1,0.0,1.0,0,6,6
SheriTreadwell,0,0.6669936125650666,0.3330063874349333,1,1.0,0.0,2,0,2
ShinobiShawn2,0,0.6156492484416662,0.3843507515583338,1,1.0,0.0,2,0,2
ShooguhLipz,0,0.6945937370064126,0.3054062629935874,-1,0.0,1.0,0,8,8
SimonCookeMSI,0,0.6606040261681515,0.3393959738318485,-1,0.0,1.0,0,5,5
sineadgallivann,0,0.6010507628407029,0.39894923715929703,-1,0.0,0.0,0,0,0
soihadanabort,0,0.5437212965784689,0.4562787034215311,-1,0.05,0.95,1,19,20
sojourner_blanc,0,0.6419531741019469,0.3580468258980531,-1,0.0,1.0,0,2,2
strangemoore,0,0.7170055864020428,0.2829944135979572,-1,0.0,1.0,0,1,1
sydneyrenee3,0,0.5469501907382828,0.4530498092617172,-1,0.0,1.0,0,1,1
T2theGuajardo,1,0.2916394832537954,0.7083605167462046,1,1.0,0.0,5,0,5
The_Alma_D,0,0.6014774779013654,0.39852252209863465,-1,0.0,1.0,0,13,13
thejacksonlacy,0,0.6788795035161668,0.32112049648383323,-1,0.0,1.0,0,1,1
thejessicaraven,0,0.7143590807475317,0.2856409192524683,-1,0.25,0.75,1,3,4
TheOpenMicah,0,0.5914799124280014,0.40852008757199865,1,1.0,0.0,2,0,2
tideslifefaith,1,0.27701583262069496,0.722984167379305,1,1.0,0.0,4,0,4
tjbayus1,0,0.6007911882290187,0.3992088117709814,1,1.0,0.0,1,0,1
tkose98,0,0.6647777052519384,0.3352222947480616,-1,0.0,1.0,0,1,1
TomBurdolski,1,0.16163406117942547,0.8383659388205745,1,1.0,0.0,11,0,11
toratannerchung,0,0.7264546333174149,0.27354536668258506,-1,0.0,1.0,0,1,1
Trevor_Horne,0,0.6627167736929214,0.3372832263070787,-1,0.0,1.0,0,1,1
trianglescheme,0,0.6823756017914133,0.3176243982085866,-1,0.0,1.0,0,7,7
turnerdina1,1,0.32243387861263584,0.6775661213873642,1,1.0,0.0,4,0,4
UKStorageGuru,0,0.6132019112345195,0.38679808876548055,1,1.0,0.0,1,0,1
vailkoyo,0,0.6411717573997411,0.35882824260025886,-1,0.0,1.0,0,2,2
VERASTEGUI100,1,0.10655195842232235,0.8934480415776777,1,0.9473684210526316,0.05263157894736842,18,1,19
Vikar_Singh,0,0.6535387348659044,0.3464612651340956,-1,0.0,1.0,0,2,2
VLabarum,1,0.43426445450168116,0.5657355454983188,1,0.9230769230769232,0.07692307692307693,12,1,13
wafulkerson1,0,0.6010507628407029,0.39894923715929703,1,1.0,0.0,2,0,2
WarrenDavidson,1,0.2498690481994641,0.7501309518005359,1,0.9,0.1,9,1,10
WilsonRx,1,0.36497138164144527,0.6350286183585547,1,1.0,0.0,3,0,3
wordspurify27,0,0.5690503439804573,0.4309496560195427,-1,0.0,1.0,0,3,3
