account_name,predict_class,prochoice_strength,prolife_strength,prolife proportion,prochoice proportion,prolife cnt,prochoice cnt,total cnt,account_type
40daysforlife,1,0.1639947713383626,0.8360052286616374,1.0,0.0,18,0,18,1
AbolitionAHA,1,0.20586471254970973,0.7941352874502903,1.0,0.0,16,0,16,1
AbortionGroup,1,0.26628067290715607,0.7337193270928439,0.9666666666666668,0.03333333333333333,29,1,30,1
AmerLifeLeague,1,0.08848673487983227,0.9115132651201677,0.95,0.05,19,1,20,1
AntiAbrtionGang,1,0.17236915246988394,0.8276308475301161,1.0,0.0,21,0,21,1
AUL,1,0.12690578008115516,0.8730942199188448,0.9047619047619048,0.09523809523809523,19,2,21,1
Bound4LIFE,1,0.33978326301060213,0.6602167369893979,0.9615384615384616,0.038461538461538464,25,1,26,1
CA_ProLife,1,0.08706423752306292,0.9129357624769371,0.9629629629629628,0.037037037037037035,26,1,27,1
ExposeAbortion,1,0.11187045512353355,0.8881295448764664,1.0,0.0,18,0,18,1
FightAbortion,1,0.09739623847870382,0.9026037615212962,0.9583333333333334,0.04166666666666666,23,1,24,1
frfrankpavone,1,0.1066973502002655,0.8933026497997345,0.9666666666666668,0.03333333333333333,29,1,30,1
HumanCoalition,1,0.2063406228317377,0.7936593771682623,0.9642857142857144,0.03571428571428571,27,1,28,1
KeepLifeLegal,1,0.1660160240806845,0.8339839759193155,1.0,0.0,20,0,20,1
LdnAntiAbortion,1,0.37115616686380204,0.628843833136198,0.8,0.2,4,1,5,1
LGBTQProLife,1,0.093069269560065,0.906930730439935,0.9230769230769232,0.07692307692307693,12,1,13,1
LifeNewsHQ,1,0.12697182026462261,0.8730281797353774,0.9696969696969696,0.030303030303030307,32,1,33,1
LilaGraceRose,1,0.2045275947226871,0.7954724052773129,1.0,0.0,14,0,14,1
LiveAction,1,0.1761348810767277,0.8238651189232723,0.7916666666666666,0.20833333333333331,19,5,24,1
NeverAbortion,1,0.14774775057033573,0.8522522494296643,0.75,0.25,3,1,4,1
nrlc,1,0.0723753379983676,0.9276246620016324,0.9473684210526316,0.05263157894736842,18,1,19,1
operationrescue,1,0.1317335032184208,0.8682664967815792,0.7857142857142857,0.21428571428571427,11,3,14,1
PLAM_org,1,0.08802438307674254,0.9119756169232575,0.9444444444444444,0.05555555555555555,17,1,18,1
ProLifeAction,1,0.10267274830137985,0.8973272516986202,0.9310344827586208,0.06896551724137931,27,2,29,1
prolifealliance,1,0.279483407457903,0.720516592542097,0.6363636363636364,0.3636363636363637,7,4,11,1
ProLifeBlogs,1,0.08921078862627774,0.9107892113737223,1.0,0.0,24,0,24,1
prolifecampaign,1,0.19024676861220502,0.809753231387795,0.967741935483871,0.03225806451612903,30,1,31,1
ProLifeDem,1,0.23822177858869165,0.7617782214113084,0.9090909090909092,0.09090909090909093,10,1,11,1
ProLifeLSU,1,0.36705943455713197,0.632940565442868,0.9333333333333332,0.06666666666666668,14,1,15,1
ProLifeMastery,1,0.16107655900913065,0.8389234409908694,0.0,0.0,0,0,0,1
prolifenews,1,0.09962468989189377,0.9003753101081062,0.0,0.0,0,0,0,1
ProLifePolitics,1,0.23154218880344302,0.768457811196557,0.76,0.24,19,6,25,1
prolifepoppop,1,0.2677419687717304,0.7322580312282696,0.8292682926829268,0.17073170731707318,34,7,41,1
ProLifeYouth,1,0.13860359108549125,0.8613964089145087,1.0,0.0,25,0,25,1
recallabortion,1,0.2935006408924741,0.7064993591075259,0.9285714285714286,0.07142857142857142,26,2,28,1
RosaryMovement,1,0.4375231529021446,0.5624768470978554,1.0,0.0,12,0,12,1
SanDiegoProLife,1,0.18493798321953858,0.8150620167804614,0.9545454545454546,0.045454545454545456,21,1,22,1
SBAList,1,0.0923018180763665,0.9076981819236335,0.8823529411764706,0.1176470588235294,30,4,34,1
spucprolife,1,0.13682149933376053,0.8631785006662395,0.8571428571428571,0.14285714285714285,30,5,35,1
usccbprolife,1,0.2051324561981599,0.7948675438018401,0.9565217391304348,0.043478260869565216,22,1,23,1
WeAreProLife_,1,0.2897449911210942,0.7102550088789058,1.0,0.0,4,0,4,1
abortion_clinic,0,0.8303550060248125,0.1696449939751875,0.0,1.0,0,6,6,0
Abortion_Rights,0,0.8610134372581184,0.13898656274188162,0.0,1.0,0,23,23,0
AbortionCare,0,0.8475325573315944,0.15246744266840562,0.043478260869565216,0.9565217391304348,1,22,23,0
AbortionFunds,0,0.8136833796699261,0.18631662033007393,0.0,1.0,0,31,31,0
abortionpil,0,0.8967430963039168,0.10325690369608316,0.047619047619047616,0.9523809523809524,1,20,21,0
AbortionRights,0,0.8007348140547511,0.19926518594524892,0.0,1.0,0,6,6,0
AbortionStories,0,0.7823843792814185,0.2176156207185816,0.0,1.0,0,18,18,0
AbortionSupport,0,0.8474858455455204,0.15251415445447958,0.0,1.0,0,26,26,0
AcpAbortion,0,0.847583442891008,0.15241655710899207,0.03333333333333333,0.9666666666666668,1,29,30,0
alranztweets,0,0.7627916338452692,0.2372083661547309,0.0,1.0,0,7,7,0
BaltimoreFund,0,0.8567594814509516,0.1432405185490484,0.043478260869565216,0.9565217391304348,1,22,23,0
BronxAbortion,0,0.8516764219336443,0.14832357806635568,0.0,1.0,0,13,13,0
ChiAbortionFund,0,0.8735775004119802,0.1264224995880198,0.0,1.0,0,17,17,0
DCAbortionFund,0,0.7655930494537588,0.23440695054624122,0.04166666666666666,0.9583333333333334,1,23,24,0
Doctors4Choice,0,0.8563718469875532,0.14362815301244675,0.04,0.96,1,24,25,0
Feminists4Life,1,0.36637182339741015,0.6336281766025899,1.0,0.0,5,0,5,0
freesafelegal,0,0.8502933466253065,0.14970665337469347,0.043478260869565216,0.9565217391304348,1,22,23,0
LPJLeague,0,0.8463888162088884,0.15361118379111163,0.0,1.0,0,21,21,0
MSFC,0,0.8722175007380416,0.1277824992619584,0.0,1.0,0,17,17,0
NatAbortionFed,0,0.855798980777057,0.14420101922294307,0.0,1.0,0,26,26,0
NCAbortionFund,0,0.8596143896069648,0.14038561039303527,0.0,1.0,0,21,21,0
NDWINFund,0,0.8517550426729174,0.14824495732708268,0.0,1.0,0,14,14,0
needabortionire,0,0.7638870894962159,0.23611291050378416,0.0,1.0,0,8,8,0
NJAAF,0,0.8851922976786741,0.11480770232132592,0.0,1.0,0,22,22,0
nolaAbortionFnd,0,0.8760333608223472,0.12396663917765287,0.0,1.0,0,23,23,0
NYAAF,0,0.8044664423645324,0.19553355763546762,0.0,1.0,0,21,21,0
PretermMAML,0,0.8355690826988622,0.16443091730113776,0.04,0.96,1,24,25,0
prochoiceNSW,0,0.8384293599937837,0.16157064000621638,0.0,0.0,0,0,0,0
RallyforChoice,0,0.8299671362654886,0.1700328637345114,0.0,1.0,0,12,12,0
RBraceySherman,0,0.7819954181578495,0.2180045818421506,0.0,1.0,0,23,23,0
robinmarty,0,0.7274415346534597,0.2725584653465402,0.36666666666666653,0.6333333333333333,11,19,30,0
roisiningle,0,0.7955890226532885,0.20441097734671151,0.0,1.0,0,12,12,0
Safe_Abortion,0,0.8915608623218907,0.10843913767810937,0.03448275862068965,0.9655172413793104,1,28,29,0
SeaChangeProg,0,0.8403219164558883,0.15967808354411175,0.03448275862068965,0.9655172413793104,1,28,29,0
ShoutYrAbortion,0,0.803034968049227,0.196965031950773,0.05882352941176471,0.9411764705882352,1,16,17,0
SisterSupporter,0,0.8636076436815184,0.13639235631848154,0.0,1.0,0,7,7,0
StephHerold,0,0.8181259566199703,0.1818740433800296,0.0,1.0,0,25,25,0
TammiKromenaker,0,0.8234174334435752,0.1765825665564248,0.0,1.0,0,7,7,0
Voice4ChoiceUK,0,0.8710834908828452,0.12891650911715483,0.0,1.0,0,8,8,0
WholeWomans,0,0.8647057799242914,0.13529422007570863,0.03571428571428571,0.9642857142857144,1,27,28,0
